ProperTestMap
1
111000000002200000000111
110000000000000000000011
100000000003300000000001
000200000002200000002000
000000333002200333000000
000000211000000112000000
000000221003300122000000
000000000002200000000000
000000000011110000000000
000000000000000000000000
000030001000000100030000
200220021000000120022002
200220021000000120022002
000040001000000100040000
000000000000000000000000
000000000011110000000000
000000000002200000000000
000000221004400122000000
000000211000000112000000
000000444002200444000000
000200000002200000002000
100000000004400000000001
110000000000000000000011
111000000002200000000111
